{
    "tiles" : [[1,1,1,1,1,1,1,1,1],
               [1,1,1,1,1,1,1,1,1],
               [1,1,1,0,1,1,0,1,1],
               [1,1,1,0,1,1,0,1,1],
               [1,1,1,0,0,0,0,1,1],
               [1,1,1,0,0,0,0,1,1],
               [1,1,1,0,1,1,0,1,1],
               [1,1,1,1,1,1,1,1,1],
               [1,1,1,1,1,1,1,1,1]],
    
    "targetScore" : 11500,
    "moves" : 43,
}

