{
    "tiles" : [[1, 1, 1, 1, 1, 1, 1, 1, 1 ],
               [1, 1, 1, 1, 1, 1, 1, 1, 1 ],
               [1, 1, 1, 1, 1, 1, 1, 1, 1 ],
               [0, 1, 1, 1, 1, 1, 1, 1, 0 ],
               [1, 0, 1, 1, 1, 1, 1, 0, 1 ],
               [1, 1, 0, 1, 1, 1, 0, 1, 1 ],
               [1, 1, 1, 0, 1, 0, 1, 1, 1 ],
               [1, 1, 1, 1, 0, 1, 1, 1, 1 ],
               [1, 1, 1, 1, 1, 1, 1, 1, 1 ] ],
    
    "targetScore" : 34500,
    "moves" : 70,
}