{
    "tiles" : [[1,1,0,0,1,1,1,0,0],
               [1,1,0,0,1,1,1,0,0],
               [1,1,0,0,1,1,1,0,0],
               [1,1,0,0,1,1,1,0,0],
               [1,1,0,0,1,1,1,0,0],
               [1,1,0,0,1,1,1,0,0],
               [1,1,0,0,1,1,1,0,0],
               [1,1,1,1,1,1,1,1,1],
               [1,1,1,1,1,1,1,1,1] ],
    
    "targetScore" : 2990,
    "moves" : 18,
}
