{
    "tiles" : [[0, 1, 1, 1, 1, 1, 1, 1, 0 ],
               [0, 1, 1, 1, 1, 1, 1, 1, 0 ],
               [0, 1, 1, 1, 1, 1, 1, 1, 0 ],
               [0, 1, 1, 1, 1, 1, 1, 1, 0 ],
               [0, 0, 0, 0, 0, 0, 0, 0, 0 ],
               [1, 1, 1, 1, 0, 1, 1, 1, 1 ],
               [1, 1, 1, 1, 0, 1, 1, 1, 1 ],
               [1, 1, 1, 1, 0, 1, 1, 1, 1 ],
               [1, 1, 1, 1, 0, 1, 1, 1, 1 ] ],
    
    "targetScore" : 14500,
    "moves" : 45,
}

