{
    "tiles" : [[0, 0, 0, 0, 0, 0, 0, 0, 0 ],
               [0, 0, 1, 1, 1, 1, 0, 0, 0 ],
               [1, 1, 1, 1, 1, 1, 1, 1, 0 ],
               [1, 1, 1, 1, 1, 1, 1, 1, 0 ],
               [0, 1, 1, 1, 1, 1, 1, 0, 0 ],
               [0, 1, 1, 1, 1, 1, 1, 0, 0 ],
               [1, 1, 1, 1, 1, 1, 1, 1, 0 ],
               [1, 1, 1, 1, 1, 1, 1, 1, 0 ],
               [0, 0, 1, 1, 1, 1, 0, 0, 0 ] ],
    
    "targetScore" : 9850,
    "moves" : 20,
}
