{
    "tiles" : [[1, 0, 1, 0, 1, 0, 1, 0, 1 ],
               [1, 0, 1, 0, 1, 0, 1, 0, 1 ],
               [1, 1, 1, 1, 1, 1, 1, 1, 1 ],
               [1, 1, 1, 1, 1, 1, 1, 1, 1 ],
               [0, 1, 1, 1, 1, 1, 1, 1, 0 ],
               [1, 1, 1, 1, 1, 1, 1, 1, 1 ],
               [1, 1, 1, 1, 1, 1, 1, 1, 1 ],
               [1, 0, 1, 0, 1, 0, 1, 0, 1 ],
               [1, 0, 1, 0, 1, 0, 1, 0, 1 ] ],
    
    "targetScore" : 7560,
    "moves" : 21,
}