{
    "tiles" : [[1, 1, 1, 1, 1, 1, 1, 1, 1 ],
               [1, 1, 1, 1, 1, 1, 1, 1, 1 ],
               [1, 1, 1, 1, 1, 1, 1, 1, 1 ],
               [1, 1, 1, 1, 1, 1, 1, 1, 1 ],
               [1, 1, 1, 1, 1, 1, 1, 1, 1 ],
               [0, 0, 0, 0, 0, 0, 0, 0, 0 ],
               [0, 1, 1, 1, 1, 1, 1, 1, 0 ],
               [0, 1, 1, 1, 1, 1, 1, 1, 0 ],
               [0, 1, 1, 1, 1, 1, 1, 1, 0 ] ],
    
    "targetScore" : 12550,
    "moves" : 25,
}