{
    "tiles" : [[1,1,1,1,1,1,1,1,1],
               [1,1,1,1,1,1,1,1,1],
               [1,1,1,1,1,1,1,1,1],
               [0,0,1,1,0,1,1,0,0],
               [0,0,1,1,0,1,1,0,0],
               [0,0,1,1,0,1,1,0,0],
               [1,1,1,1,0,1,1,1,1],
               [1,1,1,1,0,1,1,1,1],
               [1,1,1,1,0,1,1,1,1] ],
    
    "targetScore" : 2500,
    "moves" : 17,
}
