{
    "tiles" : [[1,1,1,1,0,1,1,1,1],
               [1,1,1,1,1,1,1,1,1],
               [1,1,1,1,1,1,1,1,1],
               [1,0,0,1,1,0,0,1,1],
               [1,1,1,1,1,1,1,1,1],
               [1,1,1,0,0,1,1,1,1],
               [1,1,1,0,0,1,1,1,1],
               [1,1,1,1,1,1,1,1,1],
               [0,1,1,1,1,1,1,1,0] ],
    
    "targetScore" : 13000,
    "moves" : 47,
}


