{
    "tiles" : [[1,1,1,1,1,1,1,1,1],
               [1,1,1,0,0,0,1,1,1],
               [1,1,1,0,0,0,1,1,1],
               [1,1,1,0,0,0,1,1,1],
               [1,1,1,0,0,0,1,1,1],
               [1,1,1,0,0,0,1,1,1],
               [1,1,1,1,1,1,1,1,1],
               [1,1,1,1,1,1,1,1,1],
               [1,1,1,1,1,1,1,1,1] ],
    
    "targetScore" : 10000,
    "moves" : 40,
}
