{
    "tiles" : [[0, 0, 1, 1, 0, 1, 0, 0, 0 ],
               [1, 0, 1, 1, 1, 1, 1, 0, 1 ],
               [1, 0, 1, 1, 1, 1, 1, 0, 1 ],
               [1, 1, 1, 1, 1, 1, 1, 1, 1 ],
               [1, 1, 1, 0, 0, 0, 1, 1, 1 ],
               [1, 1, 1, 1, 1, 1, 1, 1, 1 ],
               [1, 0, 1, 1, 1, 1, 1, 0, 1 ],
               [1, 0, 1, 1, 1, 1, 1, 0, 1 ],
               [0, 0, 0, 1, 0, 1, 0, 0, 0 ] ],
    
    "targetScore" : 15000,
    "moves" : 40,
}