{
    "tiles" : [[0,0,1,0,0,1,0,0,0],
               [0,0,1,0,0,1,0,0,0],
               [0,0,1,0,0,1,0,0,0],
               [0,0,1,0,0,1,0,0,0],
               [0,1,1,0,0,1,1,0,0],
               [1,1,1,1,1,1,1,1,1],
               [1,1,1,1,1,1,1,1,1],
               [1,1,1,1,1,1,1,1,1],
               [1,1,1,1,1,1,1,1,1] ],
    
    "targetScore" : 13990,
    "moves" : 56,
}

