{
    "tiles" : [[0,0,1,1,1,1,1,0,0],
               [0,0,1,1,1,1,1,0,0],
               [0,0,1,1,1,1,1,0,0],
               [0,1,1,1,1,1,1,1,0],
               [0,1,1,1,1,1,1,1,0],
               [0,1,1,1,1,1,1,1,0],
               [0,0,1,1,1,1,1,0,0],
               [0,0,1,1,1,1,1,0,0],
               [0,0,1,1,1,1,1,0,0] ],
    
    "targetScore" : 4500,
    "moves" : 21,
}

